%%%%%%%%%%%%%%%%
%P  .          %
% %%% % %%%    %
% % %%%%% % %  %
% %     % % % %%
% % %%%%% % %  %
% %         %  %
%%%%%%%%%%%%%%%%